20 20 20 20 20 20 20 20 20 20
20 1 1 3 2 2 15 3 1 20
20 2 19 19 19 19 19 19 19 20
20 2 1 15 2 3 1 1 2 20
20 19 19 19 19 19 19 19 1 20
20 1 3 2 2 1 15 1 1 20
20 1 19 19 19 19 19 19 19 20
20 1 1 1 1 2 2 15 4 20
20 19 19 19 19 19 19 19 6 20
20 20 20 20 20 20 20 20 20 20
