20 20 20 20 20 20 20 20 20 20
20 8 7 6 5 4 3 2 1 20
20 9 19 19 19 19 19 19 19 20
20 10 11 12 13 14 15 1 1 20
20 19 19 19 19 19 19 19 1 20
20 1 1 1 1 1 1 1 1 20
20 1 19 19 19 19 19 19 19 20
20 1 1 1 1 1 1 1 1 20
20 19 19 19 19 19 19 19 1 20
20 20 20 20 20 20 20 20 20 20
