1 3 7 9 9 7 5 3 3 1
3 5 9 11 11 11 9 7 3 1
5 7 11 13 15 17 13 11 5 3
7 9 13 15 17 19 15 13 7 5
9 11 13 15 17 20 19 13 9 7
7 9 11 13 13 15 17 17 11 9
5 7 9 11 11 13 15 17 13 9
3 5 7 9 9 11 13 15 13 11
1 5 7 9 7 7 9 9 11 11
1 3 5 5 3 3 5 7 9 9
