20 20 20 20 20 20 20 20 20 20
20 1 1 1 1 1 1 1 1 20
20 1 19 1 19 19 19 2 19 20
20 1 1 1 3 1 1 1 1 20
20 19 2 19 19 1 19 19 3 20
20 1 1 1 3 1 1 1 1 20
20 1 19 19 19 19 2 19 19 20
20 1 1 1 1 1 1 3 1 20
20 19 19 19 19 19 19 19 1 20
20 20 20 20 20 20 20 20 20 20
